/29/29/29/29/29/29/29/29/29/29/29/29/29/29/29/29/29/29/29/29/29/29/29/29/29/29/29/29/29/29/29/29/
/29/29/14/26/26/26/26/28/26/26/26/26/26/26/26/26/26/26/26/26/26/26/26/26/26/26/26/26/26/15/29/29/
/29/29/21/ 9/ 8/ 8/ 8/21/ 8/ 8/ 8/ 8/ 8/ 8/ 8/ 8/ 8/ 8/ 8/ 8/ 8/ 8/ 8/ 8/ 8/ 8/ 8/ 8/11/21/29/29/
/29/29/21/ 5/ 4/ 4/ 4/21/ 4/ 4/ 4/ 4/ 4/ 4/ 4/ 4/ 4/ 4/ 4/ 4/ 4/ 4/ 4/ 4/ 4/ 4/ 4/ 4/ 7/21/29/29/
/29/29/21/12/12/12/12/21/12/12/12/12/12/12/12/12/12/12/12/12/12/12/12/12/12/12/12/12/12/21/29/29/
/29/29/21/12/12/12/12/21/12/12/12/12/12/12/12/12/12/12/12/12/12/12/12/12/12/12/12/12/12/21/29/29/
/29/29/21/12/12/12/12/21/12/12/12/12/12/12/12/12/12/12/12/12/12/12/12/12/12/12/12/12/12/21/29/29/
/29/29/21/12/12/12/12/21/12/12/12/12/12/12/12/12/12/12/12/12/12/12/12/12/12/12/12/12/12/21/29/29/
/29/29/21/12/12/12/12/21/12/12/14/26/26/26/26/26/26/26/26/26/15/12/12/12/12/12/12/12/12/21/29/29/
/29/29/21/12/12/12/12/21/12/12/21/ 9/ 8/ 8/ 8/ 8/ 8/ 8/ 8/11/21/12/12/12/12/12/12/12/12/21/29/29/
/29/29/24/18/12/12/16/23/12/12/21/ 5/ 4/ 4/ 4/ 4/ 4/ 4/ 4/ 7/21/12/12/12/12/12/12/12/12/21/29/29/
/29/29/21/11/12/12/ 9/11/12/12/21/12/12/12/12/12/12/12/12/12/21/12/12/12/12/12/12/12/12/21/29/29/
/29/29/21/ 7/12/12/ 5/ 7/12/12/21/12/12/12/12/12/12/12/12/12/21/12/12/12/12/12/12/12/12/21/29/29/
/29/29/21/12/12/12/12/12/12/12/21/12/12/12/12/12/12/12/12/12/21/12/12/12/12/12/12/12/12/21/29/29/
/29/29/21/12/12/12/12/12/12/12/21/12/12/12/12/12/12/12/12/12/21/12/12/12/12/12/12/12/12/21/29/29/
/29/29/21/12/12/12/12/12/12/12/21/12/12/12/12/12/12/12/12/12/21/12/12/14/26/26/26/26/26/25/29/29/
/29/29/21/12/12/12/12/12/12/12/21/12/12/12/12/12/12/12/12/12/21/12/12/21/ 9/ 8/ 8/ 8/11/21/29/29/
/29/29/21/12/12/12/12/12/12/12/21/12/12/12/12/12/12/12/12/12/21/12/12/21/ 5/ 4/ 4/ 4/ 7/21/29/29/
/29/29/21/12/12/12/12/12/12/12/22/26/18/12/12/16/26/26/26/26/23/12/12/21/12/12/12/12/12/21/29/29/
/29/29/21/12/12/12/12/12/12/12/ 9/ 8/11/12/12/ 9/ 8/ 8/ 8/ 8/11/12/12/20/12/12/12/12/12/21/29/29/
/29/29/21/12/12/12/12/12/12/12/ 5/ 4/ 7/12/12/ 5/ 4/ 4/ 4/ 4/ 7/12/12/10/12/12/12/12/12/21/29/29/
/29/29/21/12/12/12/12/12/12/12/12/12/12/12/12/12/12/12/12/12/12/12/12/ 6/12/12/12/12/12/21/29/29/
/29/29/21/12/12/12/12/12/12/12/12/12/12/12/12/12/12/12/12/12/12/12/12/12/12/12/12/12/12/21/29/29/
/29/29/21/12/12/12/12/12/12/12/12/12/12/12/12/12/12/12/12/12/12/12/12/12/12/12/12/12/12/21/29/29/
/29/29/22/26/26/26/26/26/26/26/26/26/26/26/26/26/26/26/26/26/26/26/26/26/26/26/26/26/26/23/29/29/
/29/29/ 9/ 8/ 8/ 8/ 8/ 8/ 8/ 8/ 8/ 8/ 8/ 8/ 8/ 8/ 8/ 8/ 8/ 8/ 8/ 8/ 8/ 8/ 8/ 8/ 8/ 8/ 8/11/29/29/
/29/29/ 5/ 4/ 4/ 4/ 4/ 4/ 4/ 4/ 4/ 4/ 4/ 4/ 4/ 4/ 4/ 4/ 4/ 4/ 4/ 4/ 4/ 4/ 4/ 4/ 4/ 4/ 4/ 7/29/29/
/29/29/29/29/29/29/29/29/29/29/29/29/29/29/29/29/29/29/29/29/29/29/29/29/29/29/29/29/29/29/29/29/
/29/29/29/29/29/29/29/29/29/29/29/29/29/29/29/29/29/29/29/29/29/29/29/29/29/29/29/29/29/29/29/29/
*